Afghanistan	afgano; afgana
Isole Åland	ålandese
Albania	albanese
Algeria	algerino; algerina
Andorra	andorrano; andorrana
Angola	angolano; angolana
Anguilla	di Anguilla; aguillano
Antigua e Barbuda	di Antigua e Barbuda
Antille olandesi	delle Antille olandesi
Arabia Saudita	saudiano; saudiana; saudita
Argentina	argentino; argentina
Armenia	armeno; armena
Aruba	arubano; arubana
Australia	australiano; australiana
Austria	austriaco; austriaca
Azerbaigian	azero; azera
Bahamas	bahamense; bahamiano
Bahrain	bahreinita
Bangladesh	bangladese
Barbados	barbadiano
Belgio	belga
Belize	belizeano
Benin	beninese; beniniano; beniniana
Bermuda	delle Bermuda
Bhutan	butanese
Birmania	birmano
Bielorussia	bielorusso; bielorussa
Bolivia	boliviano; boliviana
Bosnia-Erzegovina	bosniaco; bosniaca
Botswana	botswano; botswana
Brasile	brasiliano; brasiliana
Brunei	del Brunei
Bulgaria	bulgaro; bulgara
Burkina Faso	burkinabé
Burundi	burundese
Cambogia	cambogiano; cambogiana
Camerun	camerunese
Canada	canadese
Capo Verde	caboverdiano; caboverdiana; capoverdiano; capoverdiana
Isole Cayman	delle Cayman
Ciad	ciadiano; ciadiana
Cile	cileno; cilena
Cina	cinese
Cipro	ciprio; cipria; cipriota
Colombia	colombiano; colombiana
Comore	comoriano; comoriana
Repubblica del Congo	congolese
Rep. Dem. del Congo	congolese
Isole Cook	delle Cook
Corea del Nord	nordcoreano; nordcoreana
Corea del Sud	sudcoreano; sudcoreana
Costa d'Avorio	ivoriano; ivoriana
Costa Rica	costaricano; costaricana
Croazia	croato; croata
Cuba	cubano; cubana
Danimarca	danese
Dominica	di Dominica
Ecuador	ecuadoriano; ecuadoriana
Egitto	egiziano; egiziana
El Salvador	salvadoregno; salvadoregna
Emirati Arabi Uniti	arabo; degli Emirati arabi
Eritrea	eritreo; eritrea
Estonia	estone
Etiopia	etiope
Figi	figiano; figiana
Filippine	filippino; filippina
Finlandia	finlandese
Francia	francese
Gabon	gabonese
Gambia	gambiano; gambiana
Georgia	georgiano; georgiana
Germania	tedesco; tedesca
Ghana	ghaneano; ghaneana; ghanese
Giamaica	giamaicano; giamaicana
Giappone	giapponese
Gibuti	gibutiano; gibutiana
Giordania	giordano; giordana
Grecia	greco
Grenada	grenadino; grenadina
Guadalupa	della Guadalupa
Guam	guamano
Guatemala	guatemalteco
Guernsey	di Guernsey e Alderney
Guyana Francese	guianese
Guinea	guineano; guineana
Guinea-Bissau	della Guinea-Bissau
Guinea Equatoriale	della Guinea equatoriale
Guyana	guianese
Haiti	haitiano; haitiana
Honduras	honduregno; honduregna; honduriano; honduriana
Hong Kong	cinese; di Hong Kong
India	indiano; indiana; indú
Indonesia	indonesiano; indonesiana
Iran	iraniano; iraniana
Iraq	iracheno; irachena
Irlanda	irlandese
Islanda	islanese
Israele	israeliano; israeliana
Italia	italiano; italiana
Jugoslavia	iugoslavo; iugoslava
Jersey	di Jersey
Kazakistan	kazako; kazaka
Kenya	keniota; keniano; keniana
Kirghizistan	chirghiso; chirghisa
Kiribati	di Kiribati
Kuwait	kuwaitiano; kuwaitiana
Laos	laotiano; laotiana
Lesotho	del Lesotho
Lettonia	lettone
Libano	libanese
Liberia	liberiano; liberiana
Libia	libio; libia
Liechtenstein	del Liechtenstein
Lituania	lituano
Lussemburgo	lussemburghese
Macao	di Macao
Macedonia	macedone
Madagascar	malgascio; malgascia
Malawi	malawiano; malawiana
Malesia	malese
Maldive	maldiviano
Mali	maliano
Malta	maltese
Isola di Man	dell'Isola di Man
Isole Marianne Settentrionali	delle Marianne Settentrionali
Marocco	marocchino; marocchina
Martinica	martinicano; martinicana
Isole Marshall	marshallese
Mauritania	mauro; maura; mauritano; mauritana
Mauritius	mauriziano; mauriziana
Mayotte	di Mayotte
Messico	messicano; messicana
Micronesia	micronesiano; micronesiana
Moldavia	moldavo; moldava
Monaco	monegasco; monegasca
Mongolia	mongolo; mongola; mongolico; mongolica
Montenegro	montenegrino
Montserrat	di Montserrat
Mozambico	mozambicano
Namibia	namibiano
Nauru	nauruano
Nepal	nepalese
Nicaragua	nicaraguense; nicaraguegno
Niger	nigerino
Nigeria	nigeriano
Niue	niueano
Norvegia	norvegese
Nuova Caledonia	neocaledoniano
Nuova Zelanda	neozelandese
Isola Norfolk	dell'Isola Norfolk
Oman	omano
Paesi Bassi	dei Paesi Bassi; olandese
Pakistan	pakistano
Palau	palauano
Autorità Nazionale Palestinese	palestinese
Panamá	panamense
Papua Nuova Guinea	papuano
Paraguay	paraguaiano
Perù	peruviano
Isole Pitcairn	dell'Isole Pitcairn
Polinesia francese	polinesiano
Polonia	polacco
Portogallo	portoghese
Porto Rico	portoricano
Qatar	qatariano
Repubblica Ceca	ceco
Repubblica Centrafricana	centrafricano; centroafricano
Repubblica Dominicana	dominicano
Réunion	della Riunione
Romania	romeno; rumeno
Ruanda	ruandese
Russia	russo
Sahara Occidentale	sahraui
Saint Kitts e Nevis	di Saint Kitts e Nevis
Santa Lucia	di Saint Lucia
Saint Vincent e Grenadine	di Saint Vincent e Grenadine
Saint-Pierre e Miquelon	di Saint-Pierre e Miquelon
Isole Salomone	delle Isole Salomone
Samoa	samoano; samoana
San Marino	sammarinese
Sant'Elena	di Sant'Elena
São Tomé e Príncipe	di São Tomé e Príncipe
Seychelles	seycellese
Senegal	senegalese
Serbia	serbo; serba
Sierra Leone	sierraleonese
Singapore	singaporiano; singaporiana
Siria	siriano; siriana
Slovacchia	slovacco; slovacca
Slovenia	sloveno; slovena
Somalia	somalo; somala
Spagna	spagnolo; spagnola
Saint-Martin	di Sri Lanka
Stati Uniti	americano; americana; statunitense
Sudafrica	sudafricano
Sudan	sudanese
Suriname	surinamese
Svalbard e Jan Mayen	di Svalbard e Jan Mayen
Svezia	svedese
Svizzera	svizzero; svizzera; elvetico; elvetica
Swaziland	swazi
Tagikistan	tagicco; tagicca
Taiwan	taiwanese; cinense
Tanzania	tanzaniano; tanzaniana
Thailandia	thailandese
Timor Est	di Timor Est
Togo	togolese
Tokelau	tokelauano
Tonga	tongano
Trinidad e Tobago	di Trinidad e Tobago
Tunisia	tunisino; tunisina
Turchia	turco; turca
Turkmenistan	turkmeno; turkmena; turcomanno; turcomanna
Turks e Caicos	delle Turks e Caicos
Tuvalu	tuvaluano; tuvaluana
Ucraina	ucraino; ucraina
Uganda	ugandese
Ungheria	ungherese; magiaro
Uruguay	uruguaiano
Uzbekistan	uzbeko; uzbeco
Vanuatu	di Vanuatu
Città del Vaticano	della Santa Sede; vaticano
Venezuela	venezuelano
Isole Vergini britanniche	delle Isole Vergini Britanniche
Isole Vergini americane	delle Isole Vergini Statunitensi
Vietnam	vietnamita
Wallis e Futuna	di Wallis e Futuna
Yemen	yemenita
Zambia	zambiano
Zimbabwe	zimbabwano
Isole Salomone	salomonico; salomonica
